0000000000000000000000000000000000000000000000000000000000000000000000000000
SSS1111111111100000000000001111111100000000000000001111111111111111111111110
SSS1111111111100000000000000011111100000000000000001111111111111111111111110
SSS1111111111100000000000000111111111111111111111111111111111111111111111110
0000000011111111111111111111111111111111111111111111111100000011111100000000
0000000011111111111111111111111111111111111111111111111111111111111100000000
0000000111111111111111111110000111111000000000000011111111111111111110000000
0000001111000000000000000000000111111111110000000011111111111111111111111110
0111111111000000000000000000000111111111111000000011111100000011110111111110
0111111111000000000000000000000111111111111111111111111100000011110111111110
0111111111111111111111111111111111111000111111111111111100000011110000000000
0000000111111111111111111111111111111000011111111111111111111111111000000000
0000000111111111111111111111111111111100000000000011110000000001111100000000
0000000111111110000000000000111111111111100000000011110000000001111000000000
0000000111111000001111111000001111111111111111111111111111111111111111111110
0000000111111111111111111111111111111111111111111111111111111111111111111110
0000000111111111111111111111111111111111111111111111111111111111111111110000
0000001111111111111111111111111111111111100000001111000011100000000011100000
0000011110000011111111111111100000111111110000011110000111000000000111000000
0000111111111111111111111111111111111111111000111111111111111111111111111110
0111111111111111111111111111111111111111111101111111111111111111111111111110
0111111111111111111111111111111111111111111000111111111111111111111111111110
0000111100000111111111111111110000011111110000011100001110000000001111000000
0000011111111111111111111111111111111111111111111110000111000000000111100000
0000001111111111111111111111111111111111111111111111000011100000000011110000
0000000111111111111111111111111111111111111111111111100001110000000001111000
0000000011110000011111111100000111111110000111111111110000111000000000111100
0000000001111100000000000000011111111111111111111111111111111111111111111110
0000000000111111111111111111111111111111111111111111111111111111111111111110
0111111111111111111111111111111111111101111111110111111111111111111111111110
0111111111111111111111111111111111111010111111101011111000000001111000001110
0000000000000000011111111000000011111111111111111111111111000011110000001110
0000000000000000011111111111111111111111111111111111111111100111110000001110
0000000000000000011111111111111111111111111111111111111111111111111111111110
0111111111111111111111111111111111111100011111000111111101111111111111111110
0111111111111111111111100000000001111110000000001111111000111111011111111100
0111111100000000001111100000000001111111111111111111110000011111100000000000
0111111100000000001111111111111111111111111111111111111111101111100000000000
0111111100000000001111111111111111111111111111111111111111111111000000000000
0000011111110000111111110000000000000000111111110000001111111111111111111FFF
0000011111110000111111111000000000000000111111000000000000111111111111111FFF
0000011111110000111111111100000000000001111110000000000000011111111111111FFF
0000000000000000000000000000000000000000000000000000000000000000000000000000