00000000000000000000000000000000000000000000000000000000000000000
S1111111111111000000000000011111111111111111111111111111111111110
11111111111111000000000000011111111000000000000000011111100000000
00000000111111000000000000011111111000000000000000011111100000000
00000000111111111111111111111111111000000000000000011111111111110
00000000111111111111111111111111111111111111111111111111100000000
00000001111100000000000000000001111111000001111111111111100000000
00000011110000000000000000000001111111000001111111111111100000000
00000111100000000000000000000001111111000001111111111111100000000
00001111110000000000000000000001111111111111111111111111111111110
01111111111111111111111111111111111110000000000000111110000000000
00000001111111111111111111111111111110000000000000111110000000000
00000001111111111111111111111111111111000000000000111110000000000
00000001111111100000000000001111111111111000000000111110000000000
00000001111110000011111110000011111111111100000000111111111111110
00000001111100000111111111000001111111111111111111111111111111110
00000001111000001111111111100000111111110000000001111000011110000
00000011110000011111111111110000011111111000000011110000111100000
00000111100000111111111111111000001111111100000111100001111000000
00001111000001111111111111111100000111111110001111000011110000000
01111111111111111111111111111111111111111111011111111111111111111
01111111111111111111111111111111111111111110001111111111111111111
00001111000001111111111111111100000111111100000111000011111000000
00000111100000111111111111111000001111111000000011100001111100000
00000011110000011111111111110000011111111111111111110000111110000
00000001111000001111111111100000111111110101010101111000011111000
00000000111100000111111111000001111111100000000000111100001111100
00000000011111000000000000000111111111000000000000011110000111110
00000000001111111111111111111111111110000000000000001111000011110
00000000001111111111111111111111111111111111111111111111111111110
01111111111111111111111111111111111111111111111111111111111111110
01111111111111111111111111000000011111111111000000000000000000000
00000000000000000111111111000000011111111111000000000000000000000
00000000000000000111111111000000011111111111000000000000000000000
00000000000000000111111111111111111111111111111111111111111111110
01111111111111111111111111111111100000000001111111111100000000000
01111111111111111111111111111111100000000001111111111100000000000
01111111000000000011111111111111100000000001111111111100000000000
01111111000000000011111111111111111111111111111111111100000000000
01111111000000000011111111111111111111111111111111111111111111110
00000111111100001111111100000000000000000111111111110000000000000
00000111111100001111111110000000000000001111110111111000000000000
00000111111100001111111111000000000000011111100011111100000000000
00000111111100001111111111100000000000111111000001111110000000000
00000111111111111111111111110000000001111110000000111111000000000
00000000000000000000011111111000000011111100000000011111100000000
00000000000000000000111111111100000111111000000000001111110000000
00000000000000000001111111111110001111110000000000000111111000000
00000000000000000011111111111111011111100000000000000011111100000
00000000000000000111111111111111111111111111111111111111111111110
00000000000000001111111111111111111111111111111111111111111111110
00000000000000011111111000000000000000000000000000000000000000000
00000000000000111111110000000000000000000000000000000000000000000
0111111111111111111111111111111111111111111111111111111111111111F
00000000000000000000000000000000000000000000000000000000000000000
